WWWWWWWWWWWWWWWW
WL       T    LW
W   G   TBT G  W
W   TTTTTBBT  MW
WP GBBBBBBBBTMTS
W   TTTTTBBT  MW
W   G   TBT G  W
WL       T    LW
WWWWWWWWWWWWWWWW