WWWWWWWWWWWWWWWW
W  M BB   BB M W
W   BBBB BBBB  W
W  MBBBBBBBBBM W
S    BBBBBBB   W
W  M  BBBBB  M W
W      BBB     W
W  M    B     PW
WWWWWWWWWWWWWWWW