WWWWWWWWWWWWWWWW
WSBL     B     W
WBWWWWWWWTWWWWBW
W      B      LW
WBWWWWWTWWWWWWWW
WL             W
WWWWWTWWWWWWWWBW
WP   B        LW
WWWWWWWWWWWWWWWW